010000000000010
111020202020111
010002020200010
000000000000000
020000000000020
002000000000200
020000000000020
002000000000200
020000000000020
000000000000000
010002020200010
111020202020111
100000000000000