000000000000000
444444444444000
333333333333000
000000000000000
000000000000000
333334444433333
000000000000000
000000000000000
333334444433333
000030000030000
000040000040000
000040000040000
000040000040000