110022222220011
100000000000001
002222210122200
001000110100200
001111010100200
000000000011200
002222000222200
001210012200200
002002020000000
002001020000100
002221022220100
100000000000001
110000000000000