000000000000000
000000000000000
100000000000001
000000000000000
100000000000001
000000000000000
100000000000001
000000000000000
100000000000001
000000000000000
100000000000001
000000000000000
000001000010000